20
15
11111111111111111111
12222222222222222111
11111111111111112111
11111111111111112111
12222222222222222111
12111111111111112111
12111111111000112111
12111111111111112111
12111111222222222111
12111111211111111111
12111111211111111111
18282222211111111111
11211111111111111111
11222222222222223111
11111111111111111111