20
15
44444444444444444445
42222222222222222445
44444444444444442445
44444444444444442445
55555544222222222445
55555544244444442445
55555544244555442445
55555544744444442445
55555544272222222445
44444444244444444445
44444444244444444445
44222222244444444445
44244444444444444445
44222222222222223445
44444444444444444445