21
15
111111111111111111111
122222222222222222211
112111111121111111211
112111111121111111211
112111111121111111211
112111111121111111211
118111111181111111811
112222222222222222211
112111111121111111211
112111111121111111211
112111111121111111211
112111111121111111211
112111111181111111811
112222222822222228231
111111111111111111111