21
15
111111111111111111111
122222222222222222211
112111111121111111211
112111111121111111211
112111111121111111211
112111111121111111211
117111111171111111711
112222222222222222211
112111111121111111211
112111111121111111211
112111111121111111211
112111111121111111211
112111111171111111711
112222222722222227231
111111111111111111111