20
15
44444444444444444445
62222222222222222445
44444444444444442445
44444444444444442445
55555544222222222445
55555544244444462445
55555544244555442445
55555544864444442445
55555544282222222445
44444444244444444445
44444444247777774445
44222222247777774445
44244446447777774445
44222222222222223445
44444444444444444445