20
15
11111111111111111111
12222222222222222111
11111111111111112111
11111111111111112111
11111111222222222111
11111111211111112111
11111111211111112111
11111111711111112111
11111111272222222111
11111111211111111111
11111111211111111111
11222222211111111111
11211111111111111111
11222222222222223111
11111111111111111111